"a" = (/turf/template_noop,/area/template_noop)
"h" = (/obj/docking_port/stationary/huge,/obj/effect/spawner/clear,/turf/template_noop,/area/template_noop)
"Z" = (/obj/effect/spawner/clear,/turf/template_noop,/area/template_noop)

(1,1,1) = {"
aaaaZZZZZZZZZZZZZZZZZZZZZZZZZZZZZZaaaaa
aaZZZZZZZZZZZZZZZZZZZZZZZZZZZZZZZZZZZaa
aZZZZZZZZZZZZZZZZZZZZZZZZZZZZZZZZZZZZZa
aZZZZZZZZZZZZZZZZZZZZZZZZZZZZZZZZZZZZZa
ZZZZZZZZZZZZZZZZZZZZZZZZZZZZZZZZZZZZZZZ
ZZZZZZZZZZZZZZZZZZZZZZZZZZZZZZZZZZZZZZZ
ZZZZZZZZZZZZZZZZZZZZZZZZZZZZZZZZZZZZZZZ
ZZZZZZZZZZZZZZZZZZZZZZZZZZZZZZZZZZZZZZZ
ZZZZZZZZZZZZZZZZZZZZZZZZZZZZZZZZZZZZZZZ
ZZZZZZZZZZZZZZZZZZZZZZZZZZZZZZZZZZZZZZZ
ZZZZZZZZZZZZZZZZZZZZZZZZZZZZZZZZZZZZZZZ
ZZZZZZZZZZZZZZZZZZZZZZZZZZZZZZZZZZZZZZZ
ZZZZZZZZZZZZZZZZZZZZZZZZZZZZZZZZZZZZZZZ
ZZZZZZZZZZZZZZZZZZZZZZZZZZZZZZZZZZZZZZZ
ZZZZZZZZZZZZZZZZZZZZZZZZZZZZZZZZZZZZZZZ
ZZZZZZZZZZZZZZZZZZZZZZZZZZZZZZZZZZZZZZZ
ZZZZZZZZZZZZZZZZZZZZZZZZZZZZZZZZZZZZZZZ
ZZZZZZZZZZZZZZZZZZZZZZZZZZZZZZZZZZZZZZZ
ZZZZZZZZZZZZZZZZZZZZZZZZZZZZZZZZZZZZZZZ
ZZZZZZZZZZZZZZZZZZZZZZZZZZZZZZZZZZZZZZZ
ZZZZZZZZZZZZZZZZZZZZZZZZZZZZZZZZZZZZZZZ
ZZZZZZZZZZZZZZZZZZZZZZZZZZZZZZZZZZZZZZZ
ZZZZZZZZZZZZZZZZZZZZZZZZZZZZZZZZZZZZZZa
aZZZZZZZZZZZZhZZZZZZZZZZZZZZZZZZZZZZZZa
aaZZZZZZZZZZZZZZZZZZZZZZZZZZZZZZZZZZZaa
aaaaaaZZZZZZZZZZZZZZZZZZZZZZZZZaaaaaaaa
"}
