//MAP CONVERTED BY dmm2tgm.py THIS HEADER COMMENT PREVENTS RECONVERSION, DO NOT REMOVE
"a" = (
/obj/effect/spawner/clear,
/turf/template_noop,
/area/template_noop)
"H" = (
/obj/effect/spawner/clear,
/obj/effect/spawner/clear,
/turf/template_noop,
/area/template_noop)
"I" = (
/obj/effect/spawner/clear,
/obj/docking_port/stationary/medium{
	dir = 2
	},
/turf/template_noop,
/area/template_noop)
"L" = (
/turf/template_noop,
/area/template_noop)

(1,1,1) = {"
L
L
L
L
L
L
L
L
L
L
L
L
L
a
L
L
L
L
L
L
L
L
L
L
"}
(2,1,1) = {"
L
L
L
L
L
L
L
L
L
L
L
L
L
a
L
L
L
L
L
L
L
L
L
L
"}
(3,1,1) = {"
L
L
L
L
L
L
L
L
a
L
L
L
L
a
L
a
L
L
L
L
L
L
L
L
"}
(4,1,1) = {"
L
L
L
L
L
L
L
L
L
a
L
L
L
a
L
a
L
L
L
L
L
L
L
L
"}
(5,1,1) = {"
L
L
L
L
L
a
L
L
L
a
L
L
L
a
a
a
L
L
L
a
L
L
L
L
"}
(6,1,1) = {"
L
L
a
L
L
a
L
L
L
L
a
L
L
L
L
a
a
L
a
a
L
L
a
L
"}
(7,1,1) = {"
L
L
a
a
L
L
a
a
L
a
H
H
L
L
a
a
L
L
a
L
a
L
a
L
"}
(8,1,1) = {"
L
L
L
L
a
a
a
a
H
a
L
a
H
L
L
a
L
L
a
a
a
a
a
L
"}
(9,1,1) = {"
L
L
L
L
L
a
a
a
a
a
a
a
a
a
a
a
L
L
L
L
L
a
L
L
"}
(10,1,1) = {"
L
L
L
L
L
L
L
a
a
L
a
a
H
a
a
a
L
a
a
a
a
a
L
a
"}
(11,1,1) = {"
a
L
a
a
L
L
a
a
a
L
a
L
H
H
H
a
a
a
a
a
a
a
a
a
"}
(12,1,1) = {"
a
L
a
L
L
L
L
a
L
L
L
a
a
a
a
H
H
a
a
a
a
L
a
L
"}
(13,1,1) = {"
L
L
a
a
a
L
L
L
a
a
a
a
a
H
a
a
a
a
a
a
a
L
L
L
"}
(14,1,1) = {"
L
L
L
L
L
a
a
a
a
a
a
a
a
a
H
H
a
a
a
a
a
L
a
L
"}
(15,1,1) = {"
L
L
L
L
a
a
L
a
a
a
a
a
a
a
a
H
a
a
a
a
L
a
L
L
"}
(16,1,1) = {"
L
L
a
a
L
a
L
L
a
a
a
a
a
a
H
H
a
a
a
a
a
a
L
L
"}
(17,1,1) = {"
L
L
L
a
a
a
L
a
a
a
a
a
a
a
H
a
a
a
a
a
a
L
L
L
"}
(18,1,1) = {"
a
a
L
L
L
a
a
a
a
a
a
a
a
a
H
a
a
a
a
a
a
a
L
L
"}
(19,1,1) = {"
L
L
L
L
a
a
a
a
a
a
a
H
H
H
H
a
a
a
a
a
L
L
L
L
"}
(20,1,1) = {"
L
L
L
a
a
L
a
a
H
H
H
H
H
a
a
a
a
a
a
a
a
a
L
L
"}
(21,1,1) = {"
L
L
L
a
a
a
a
H
a
a
a
a
a
a
a
a
a
a
L
a
a
L
L
L
"}
(22,1,1) = {"
L
L
L
a
a
a
a
a
H
a
H
H
a
a
a
a
a
a
a
L
L
L
L
L
"}
(23,1,1) = {"
L
L
a
H
a
a
a
a
H
H
a
H
H
a
a
a
L
L
L
L
L
L
L
L
"}
(24,1,1) = {"
L
L
I
H
a
a
a
a
a
a
H
a
a
a
a
L
a
L
L
a
L
a
a
L
"}
(25,1,1) = {"
L
L
a
a
a
a
a
a
L
a
L
a
a
a
H
a
L
L
L
L
L
L
L
L
"}
(26,1,1) = {"
L
L
L
a
a
a
a
a
a
a
L
a
a
a
a
a
a
a
a
a
L
L
L
L
"}
(27,1,1) = {"
L
L
a
a
a
L
a
L
a
L
L
L
a
L
L
a
a
L
L
L
L
L
L
L
"}
(28,1,1) = {"
L
L
a
a
L
a
L
a
L
L
L
L
a
L
a
a
a
a
L
L
L
L
L
L
"}
(29,1,1) = {"
L
L
a
L
a
a
a
L
a
a
L
L
L
a
a
a
a
L
L
a
L
L
L
L
"}
(30,1,1) = {"
L
a
a
a
L
L
L
L
L
a
L
L
L
L
L
a
a
L
L
L
a
L
L
L
"}
(31,1,1) = {"
L
L
L
L
L
a
L
L
L
a
L
L
L
L
a
a
L
a
a
L
L
L
L
L
"}
(32,1,1) = {"
L
L
L
L
L
L
L
L
L
L
L
L
L
L
L
a
L
L
a
L
L
L
L
L
"}
(33,1,1) = {"
L
L
L
L
L
L
L
L
L
L
L
L
L
L
L
L
L
L
L
a
L
L
L
L
"}
(34,1,1) = {"
L
L
L
L
L
L
L
L
L
L
L
L
L
L
L
L
L
L
L
L
L
L
L
L
"}
