"a" = (/turf/template_noop,/area/template_noop)
"q" = (/obj/docking_port/stationary/huge{dir = 2},/obj/effect/spawner/clear,/turf/template_noop,/area/template_noop)
"Y" = (/obj/effect/spawner/clear,/turf/template_noop,/area/template_noop)

(1,1,1) = {"
aaaaaYYYYYYYYYYYYYYYYYYYYYYYYYYYaaaaaaa
aaYYYYYYYYYYYYYYYYYYYYYYYYYYYYYYYYYYYaa
aYYYYYYYYYYYYYYYYYYYYYYYYqYYYYYYYYYYYYa
aYYYYYYYYYYYYYYYYYYYYYYYYYYYYYYYYYYYYYa
aYYYYYYYYYYYYYYYYYYYYYYYYYYYYYYYYYYYYYY
YYYYYYYYYYYYYYYYYYYYYYYYYYYYYYYYYYYYYYY
YYYYYYYYYYYYYYYYYYYYYYYYYYYYYYYYYYYYYYY
YYYYYYYYYYYYYYYYYYYYYYYYYYYYYYYYYYYYYYY
YYYYYYYYYYYYYYYYYYYYYYYYYYYYYYYYYYYYYYY
YYYYYYYYYYYYYYYYYYYYYYYYYYYYYYYYYYYYYYY
YYYYYYYYYYYYYYYYYYYYYYYYYYYYYYYYYYYYYYY
YYYYYYYYYYYYYYYYYYYYYYYYYYYYYYYYYYYYYYY
YYYYYYYYYYYYYYYYYYYYYYYYYYYYYYYYYYYYYYY
YYYYYYYYYYYYYYYYYYYYYYYYYYYYYYYYYYYYYYY
YYYYYYYYYYYYYYYYYYYYYYYYYYYYYYYYYYYYYYY
YYYYYYYYYYYYYYYYYYYYYYYYYYYYYYYYYYYYYYY
YYYYYYYYYYYYYYYYYYYYYYYYYYYYYYYYYYYYYYY
YYYYYYYYYYYYYYYYYYYYYYYYYYYYYYYYYYYYYYY
YYYYYYYYYYYYYYYYYYYYYYYYYYYYYYYYYYYYYYY
YYYYYYYYYYYYYYYYYYYYYYYYYYYYYYYYYYYYYYY
YYYYYYYYYYYYYYYYYYYYYYYYYYYYYYYYYYYYYYY
YYYYYYYYYYYYYYYYYYYYYYYYYYYYYYYYYYYYYYa
aYYYYYYYYYYYYYYYYYYYYYYYYYYYYYYYYYYYYYa
aYYYYYYYYYYYYYYYYYYYYYYYYYYYYYYYYYYYYYa
aaYYYYYYYYYYYYYYYYYYYYYYYYYYYYYYYYYYYaa
aaaaYYYYYYYYYYYYYYYYYYYYYYYYYYYYYaaaaaa
"}
